111111
1P0001
1E1C01
1C0001
111111